                                                                          ☰    
                                                                          ☰    
                                                                          ☰    
                                                                          ☰    
                                   ███                                    ☰    
                                   d                                      ☰    
████████████████████████████████████                                      ☰    
                                   █                                      ☰    
                                   █                                      ☰    
                                   █                                      ☰    
                                   █                                      ☰    
                                   █                                      ☰    
                                   █                                      ☰    
                                   █        █                             ☰    
                                   █ ⌸      d                      ⌸ ⌸ ⌸  ☰    
                                   ████████████████████████████████████████████
