                                                                               
                                                                               
                      ███████████████████████   ██████████████████████☰█       
                                                                      ☰        
                                                                      ☰        
                                       ██████████████                 ☰        
                                         🚪     🚪                   ☰        
                                   ████████████████████               ☰        
                                      🚪      1      🚪                 ☰        
                                 █████████████████████████            ☰        
                                    🚪     ⌸     ⌸    🚪                ☰        
                               █████████████████████████████          ☰        
                                  🚪     ⌸    ⌸    ⌸     🚪             ☰        
                             █████████████████████████████████        ☰        
                                  1                                   ☰        
███████████████████████████████████████████████████████████████████████████████
