                                                                               
                                                                               
                      ███████████████████████   ██████████████████████☰█       
                                                                      ☰        
                                                                      ☰        
                                       ██████████████                 ☰        
                                         d     d                   ☰        
                                   ████████████████████               ☰        
                                      d      1      d                 ☰        
                                 █████████████████████████            ☰        
                                    d     ⌸     ⌸    d                ☰        
                               █████████████████████████████          ☰        
                                  d     ⌸    ⌸    ⌸     d             ☰        
                             █████████████████████████████████        ☰        
                                                                      ☰        
███████████████████████████████████████████████████████████████████████████████
