    █                                                                          
     █                                                                         
      █                                                                        
       █                                                                       
        █                                                                      
         █                                                                     
          █████████████████████████████████████████████████████████████████████
                        🚪                    🚪                            🚪 ⌸  
         ▞██████████████████████████████████████████████████☰██████████████████
        ▞                                                 █ ☰                  
       ▞                                                  █ ☰                  
      ▞                                                   █ ☰     █████      █ 
     ▞                                                    █ ☰ ⌸ ⌸ d   d      █ 
    ▞                                                     ████████████████☰███ 
   ▞                                                                      ☰    
████                                                                      ☰    
